[WALL]
11111111111111111111111111111111
10000000000000000000000000000001
10000000000000000000000000000001
10000000000000000000000000000001
10000000000000000000000000000001
10000000000000000000000000000001
10000000000000000000000000000001
10000000000000000000000000000001
10000000000000000000000001111111
10000000000000000000000001111111
10000000000000000000000001111111
10000000000000000000000001111111
10000000000000000001111111111111
10000000000000000001111111111111
11111111100000000001111111111111
11111111100000000001111111111111
11111111100000000001111111111111
11111111100000000001111111111111
11111111111111111111111111111111
<IMAGES>
FOREGROUND=testlevel.bmp
</IMAGES>
<GUYS>
<GUY>
X_POS=400
Y_POS=520
START_TIME=0
START_DIRECTION=1
</GUY>
</GUYS>
<BOXES>
<BOX>
X_POS=400
Y_POS=500
X_SPEED=0
Y_SPEED=0
START_DIRECTION=-1
</BOX>
</BOXES>
