[WALL]
11111111111111111111111111111111
10000000000000000000000000000001
10000000000000000000000000000001
10000000000000000000000000000001
10000000000000000000000000000001
10000000000000000000000000000001
10000000000000000000000000000001
10000000000000000000000000000001
10000000000000000000000001111111
10000000000000000000000001111111
10000000000000000000000001111111
10000000000000000000000001111111
10000000000000000001111111111111
10000000000000000001111111111111
11111111100000000001111111111111
11111111100000000001111111111111
11111111100000000001111111111111
11111111100000000001111111111111
11111111111111111111111111111111
11111111111111111111111111111111
11111111111111111111111111111111
<BOXES>
<BOX>
X_POS=300
Y_POS=200
X_SPEED=0
Y_SPEED=0
</BOX>
<BOX>
X_POS=400
Y_POS=200
X_SPEED=0
Y_SPEED=0
</BOX>
<BOX>
X_POS=380
Y_POS=120
X_SPEED=0
Y_SPEED=0
</BOX>
<BOX>
X_POS=800
Y_POS=160
X_SPEED=-10
Y_SPEED=-2
</BOX>
<BOX>
X_POS=680
Y_POS=60
X_SPEED=0
Y_SPEED=5
</BOX>
<BOX>
X_POS=420
Y_POS=270
X_SPEED=0
Y_SPEED=0
</BOX>
<BOX>
X_POS=380
Y_POS=160
X_SPEED=0
Y_SPEED=0
</BOX>
<BOX>
X_POS=300
Y_POS=160
X_SPEED=0
Y_SPEED=-10
</BOX>
<BOX>
X_POS=250
Y_POS=160
X_SPEED=5
Y_SPEED=-5
</BOX>
<BOX>
X_POS=360
Y_POS=80
X_SPEED=0
Y_SPEED=0
</BOX>
</BOXES>
