11111111111111111111111111111111
10000000000000000000000000000001
10000000000000000000000000000001
10000000000000000000000000000001
10000000000000000000000000000001
10000000000000000000000000000001
10000000000000000000000000000001
10000000000000000000000000000001
10000000000000000000000001111111
10000000000000000000000001111111
10000000000000000000000001111111
10000000000000000000000001111111
10000000000000000001111111111111
10000000000000000001111111111111
11111111100000000001111111111111
11111111100000000001111111111111
11111111100000000001111111111111
11111111100000000001111111111111
11111111111111111111111111111111
11111111111111111111111111111111
11111111111111111111111111111111
